[^TRILINGUAL HERB GLOSSARY^]

|P_291 
[\f. 69v\] Arnoglossa: gall. plauntayne, angl. weybrode 
Marrubium: gall. maroyl, angl. horwnde 
Puclosa: gall. bugle, angl. pude 
Apium: gall. hache, angl. merche 
Quinquefolium: gall. cincfoille, angl. viflef 
Saniculum: gall. sanicle, angl. wodemerche 
Synapis: gall. senevey, angl. 
Menta: gall. mente, angl. mynte 
Morella: gall. morele, angl. myxplonte 
Artemesia: gall. armoes, angl. mugwrt 
Absinthium: gall. aloyne, angl. wermod 
Alna: gall. alne, angl. gretwort vel scabbewort 
Betonica: gall. vetoine, angl. betonie 
Cerefolium: gall. cerfoille, angl. fille 
Fuligo: gall. swye, angl. sot 
Abrotanum: gall. averoyne, angl. suþrenewode 
Anetum: gall. aneit, angl. dyle 
Mentastrurn: gall. mentastre, angl. horsemynte 
Confiria: gall. confirie, angl. galloc 
Lubesticum: gall. luvache, angl. luvestiche 
Senecio; gall. senesun, angl. grundeswylie 
Regina: gall. reyne, angl. medewort 
Panis kukuli: gall. payn kuku, angl. wodesure 
Archangelica: gall. morte urtye, angl. blinde netle 
Pes pulli: gall. pepol, angl. remmesfot 
[\f. 70r\] Savenella: angl. crowes(l)ope 
Glutum: gall. gletenere, angl. clote 
Filex arboratica / vel polipodium /: gall. feugerole, angl. everfe[{r{]n 
Butinius: gall. butuner, angl. heuppe 
Nasturacium: gall. kersun, angl. tunkerse 
Olerosa: gall. alissaundre, angl. 
Celidonius: gall. celydoyne, angl. 
Napus: gall. navet, angl. nep 
Vinea: gall. vynne, angl. parvenke 
Gladiolum: gall. glaiol, angl. gladene 
Febrifugia: gall. feverfoil, angl. veþervoye 
Tanazetum: gall. - angl. tanesy 
Vermiculi: gall. waraunce, angl. 
|P_292 
Raphanum: gall. rayz, angl. radich 
Alga: gall. - angl. sewor 
Herba munda: gall. sparge, angl. 
Spika: gall. lavendre, angl. 
Ascolonya: angl. hemelok 
Ambila: angl. lek 
Acinus: angl. hyndeberye 
Ambroria: angl. hyndehalethe 
Artemesya: angl. mugwort 
Apollinaris: angl. gloswort 
Astula regia: angl. balso popy 
Acetula: angl. garlek 
Acantan: angl. blewort 
Anedus: angl. hertclavre 
Acolonia: angl. cipe 
Agrimonia: angl. feldwort 
Althea eviscum: angl. mersmalue 
Absinthium: angl. weremod 
[\f. 70v\] Anteleuce: angl. smalþistel 
Apparina: angl. clive 
Anchorum: angl. madere 
Apis silvestica: angl. wodemerche 
Althee: angl. smynte 
Abrotanum: angl. suþrenewode 
Alphitum: angl. huate 
Alexandria: angl. tunmerche 
Alica: angl. genus frumenti 
Anagallis: angl. swinesnhep 
Acantes: angl. 
Ariotidas: angl. juniperi fructus 
Asboli: angl. soot 
Arsenico[{n{]: angl. orpiment 
Aspactu: angl bromesrote 
Alief(l)os: angl. pyonie 
Asclepis: angl dragaunce 
Almones: angl. wylde popy 
Sambucus: angl. elren 
Assarum: angl. yerdgalle 
Affodillus: angl. popy 
Alphita: angl. brenemele 
Antierotis: angl. elrenblosme 
Alipiados: angl. laureole lef 
Affiradix: angl. gladene 
Altercus: angl. hennebane 
|P_293 
Assuetus: ang. 
Aloxantus: ang. smal salt 
Ameracii: ang. moderwort 
Ampelo melinas: ang. 
Agnis [{s{]perma: ang. senlei~ sed 
Apoquimatus: ang. siþeshore 
Agallis: ang. kockel 
Algafotes: ang. pyonie 
Amantum: ang. ayselle 
Aguus: ang. seal 
Acalithis: ang. netlesed 
Accinos: ang. puttoc 
Afalax: ang. moldewerp 
Amirca: ang. drasten of ely 
Astragulus: ang. swnesfot 
Amesate: ang. walewort 
Acopon: ang. malue 
Agriontaphilon: ang. wilfeldmor 
Antirina: ang. savyne 
Ambrosia: ang. thusondlef 
[\f. 71r\] Adiantus: angl. stanbreche 
Apium rusticum: angl. cloveþunge 
Aglaofatis: angl. pyonie 
Ampeleleucum: angl. wilde sarfe 
Accorum, affrodisia: angl. lavre 
Aspiagme: angl. seuulile 
Allium: angl. garlek 
Asclepias: angl. dragaunce 
Avellana: angl. haselnote 
Amigdola: angl. walnote 
Anesis: angl. reste 
Agrimonia: angl. gorclive 
Aron senapionis: angl. senevey 
Apidia: pere, angl. scrippe 
Asplenum: angl. mildwort 
Antemum: angl. camomilla 
Acidula: angl. sinfulle 
Egriocananum: angl. gritte 
Arsenium: angl. orpiment 
Agaricum: angl. tunder 
Affodillum: 
Albucium: angl. parelee 
Acrocordana: angl. werte 
Acrocerium: angl. feldwort 
|P_294 
Adriaca: angl. gallok 
Argitilla: angl. culnerebac 
Apiaster: angl. wodemarche 
Aprirotarium: angl. wilde redich 
Amo[{r{]filia: angl. clote 
Anta: angl. eferrote 
Annuosa: angl. escrote 
Arboratica: angl. eververn 
Algea: angl. flotwort 
Aristologia: ang. smerewort 
Absinuatica: angl. idem 
Allevuus: angl. walewort 
Appollogamus: ang. unf(r)ordtrede 
Ablacca: angl. crodwanbam 
Astula regia: ang. woderove 
Asphodillus: ang. idem 
Aspiafucum: ang. beowort 
Astrilla: ang. atterlothe 
Alumen: ang. elm 
Amigdalus: ang. strue 
Acucule: ang. croppal 
Archiatis: ang. hehlace 
[\f. 71v\] Acitellium: angl. ramese 
Arsenicocistis: angl. spelles appel 
Aspaltu: angl. autunon 
Basiliscus: angl. genciane 
Brassica: angl. wodeciervele 
Bidella: angl. lache 
Britonica: angl. wilde bete 
Bletus: angl. cal 
Butalmun agon: angl. mugwort 
Balanus: angl. aecerne 
Brateon: angl. savyne 
Bulbus studium: angl. lupinesblosme 
Buglossa: angl. oxetunge 
Briu: angl. sauge 
Becicon: angl. horsehove 
Bania: angl. wynberieblosme 
Bromus: angl. ate 
Baca: angl. laureberie 
Bacanum: angl. redich, nep 
Besed: angl. riercestan 
Butalmum: angl. oxeshege 
Boreo: angl. þistelblosme 
|P_295 
Balsamita: angl. horsmynte 
Buglossa: angl. foxesglove 
Bacinia: angl. berige 
Beneolente: ang. mayþe 
Batracion: angl. clofwort 
Bucstalium: ang. hindemayþe 
Beriballum: ang. gre(n)tewort 
Betonica: ang. betonye 
Brassica: ang. wodecervele 
Barba Jovis: ang. synegrene 
Bonades: ang. stanmerchesede 
Brionia: ang. kufetwort 
Beteta: ang. hundestunge 
Bitumen: ang. brimstan 
Bilala: ang. rudewort 
Batus: ang. bremelberie 
Buniodes: ang. safis 
Botrocos: ang. frosca, rana 
Bonades: ang. merchessed 
Becion: ang. sauge 
Beseon: ang. þistelblosme 
Balaustia: ang. hundredlef 
Broina: ang. hemeloc 
Brassi[{c{]a: ang. calfrankis 
[\f.72r\] 
Bletum: angl. clote 
Britannica: angl. culeb 
Brogus: angl. hader 
Boatium: angl. efordrote 
Berbenace: angl. aeswort 
Betunus: ang. heope 
Britium: angl. kirse 
Bacina: ang. blakeberie 
Berbescum: ang. gescatwort 
Bardana: ang. cleate 
Cinoglorus: ang. ribbewort 
Cliton: ang. clote 
Cardamon: angl. cirse 
Camaleon: ang. eordcrop 
Catharticum: ang. lebcorn 
Camerete: ang. helenemore 
Centaurea: ang. yerdgalle 
Corsa: ang. thunga 
Calitricem: ang. swetwort 
Coliandrum: ang. celendre 
|P_296 
Camemelon: angl. se brede 
Cicuta: ang. wodewistle 
Coniee: ang. lovestiche 
Caceffa: angl. wite clavere 
Ciclamina: ang. slite 
Calta: angl. red clavere 
Colocus: ang. everefern 
Centenodia: ang. swinescarse 
Colatidis: ang. synegrene 
Canafel: angl. henep 
Cerussa: angl. huit of lede 
Cicoria: angl. cycorie 
Citalos: angl. pumyz 
Cinolea: angl. creye 
Crustacimolea: ang. þistlesdust 
Cias: angl. elidegold 
Canduelis: ang. lindetwig 
Calitriscum: angl. eal[{i{]vre 
Cariscus: angl. kinhbeam 
Comui: angl. wodewistle 
Coceorion: angl. wilde vetonie 
Cimbalatria: ang. ymglidegold 
Cocoinidum: ang. laureole sed 
Carda(mo)mum: ang. tunkarse
Cissa: angl. yvysed 
Crommyrion: ang. hundescive
[\f. 72v\] Capsitis: angl. walewort
Crin(r)isleucorum / lilium /: angl. lilie
Cariotas: angl. wildefeldmore
Cosmice: angl. betouneke
Colopendria: angl. stanbreche
Cameleonta: angl. ybleche thistel
Crimaureos: angl. ok appel
Cicideros: angl. ballocwort
Codion: angl. wilde popy
Cronopos: angl. lylie
Codia: angl. popyesheved oþer blosme
Ceforeos: angl. horsefot
Celtica: angl. brembelberie
Colofonia: angl. isoden stor
Cariobasilicon: angl. haselnote
Cirifolio: angl. wilde þistel
Cacreos: angl.
Crissocantus: angl. ivi; ciros, clive
|P_297 
Camela: angl. laureole 
Centro: angl. mil 
Cipermii: angl. resse od the stor 
Crascii: angl. criu 
Cumario: angl. thirstel 
Columbaria: angl. wilde mente 
Camedreos: ang. culbeb oke 
Colena: angl. seg 
Catona: angl. witbeam 
Citalona: ang. huite clavere 
Cliriza: ang. liquorice 
Culuna: ang. mayþe 
Clis: angl. pyonesed 
Calamentis: ang. cirecped 
Cameactis: ang. walwort 
Congelidos: ang. nep 
Carabus: ang. greshoppe 
Cetria: angl. ymolte pich 
Cindelis: angl. netle 
Cetivi: angl. brom 
Comospermaton: ang. wodewistlesed 
Canterides: ang. hoame 
Cheloni: ang. snayl 
Corax: ang. reven 
Corom: ang. crowe 
Cissos malus: ang. blac ivi 
Cossifos: ang. þrostle 
Cissa: ang. pye 
 
